[
  "11111111111111111111111111111111",
  "11000000000000000000000000000011",
  "11000000000000000000000000000011",
  "11000000000000000000000000000011",
  "11111111000011111111111111111111",
  "11000000000000000000000000000011",
  "11000000000000000000000000000011",
  "11000000000000000000000000000011",
  "11111111111111111111000011111111",
  "11000000000000000000000000000011",
  "11000000000000000000000000000011",
  "11000000000000000000000000000011",
  "11111111000011111111111111111111",
  "11000000000000000000000000000011",
  "11000000000000000000000000000011",
  "11000000000000000000000000000011",
  "11111111111111111111000011111111",
  "11000000000000000000000000000011",
  "11000000000000000000000000000011",
  "11000000000000000000000000000011",
  "11111111000011111111111111111111",
  "11000000000000000000000000000011",
  "11000000000000000000000000000011",
  "11000000000000000000000000000011",
  "11111111111111111111111111111111"
]