{
  "geometry": [
    "11111111111111111111111111111111",
    "11000000000000000000000000000011",
    "11000000000000000000000000000011",
    "11000000000000000000000000000011",
    "11000000000000111100000000000011",
    "11000000000000000000000000000011",
    "11000000000000000000000000000011",
    "11000000000000000000000000000011",
    "11111111000011111111000011111111",
    "11000000000000000000000000000011",
    "11000000000000000000000000000011",
    "11000000000000000000000000000011",
    "11111100001111111111110000111111",
    "11000000000000000000000000000011",
    "11000000000000000000000000000011",
    "11000000000000000000000000000011",
    "11000000111111111111111100000011",
    "11000000000000000000000000000011",
    "11000000000000000000000000000011",
    "11000000000000000000000000000011",
    "11000011111111111111111111000011",
    "11000000000000000000000000000011",
    "11000000000000000000000000000011",
    "11000000000000000000000000000011",
    "11111111111111111111111111111111"
  ],
  "enemies": [
    "A/2/3"
  ]
}
